2 2 2 2 2 2 2 2 2 2 2 2 2 2 2 2 2 2 2 2 2
0 0 0 0 1 0 0 0 5 0 0 0 0 0 0 0 0 1 0 2 2
2 0 0 0 0 0 0 0 1 1 0 6 0 0 1 1 1 0 0 2 2
2 0 0 0 1 0 0 0 0 0 0 0 0 0 1 0 0 0 0 2 2
2 1 0 0 1 0 0 1 1 0 0 0 1 0 0 0 0 5 0 2 2
2 0 0 0 0 0 0 0 1 1 0 1 1 1 0 0 5 0 0 2 2
2 0 0 0 1 1 0 0 0 1 0 0 0 0 0 0 0 0 0 2 2
2 0 1 0 0 0 0 0 0 0 0 0 0 0 1 0 0 5 0 2 2
2 0 0 1 0 0 0 4 4 4 4 4 0 0 0 1 0 0 0 2 2
2 6 0 0 0 0 4 3 3 3 3 3 4 0 0 0 1 0 1 2 2
2 0 0 1 0 0 0 4 4 4 4 4 0 0 6 0 0 0 0 2 2
2 0 0 1 1 1 0 0 0 0 0 0 1 0 0 0 1 0 0 2 2
2 1 0 0 0 1 0 0 0 1 1 1 1 0 0 1 0 0 0 2 2
2 0 0 0 3 0 0 5 0 1 0 0 0 0 0 0 6 0 0 2 2
2 0 0 0 0 0 1 0 0 0 0 5 0 0 0 1 0 0 0 9 2
2 2 2 2 2 2 2 2 2 2 2 2 2 2 2 2 2 2 2 2 2